{
	"LevelTileArray":[
		[1,1,1,1,1,1,1,1,1,1,1,1,1,1,1,1,1,1,1,1],
		[1,1,1,0,5,0,0,0,0,1,1,1,0,5,1,0,0,5,1,1],
		[1,1,1,0,4,0,1,1,0,1,0,0,0,0,1,0,4,0,1,1],
		[1,1,1,1,0,1,1,1,0,0,0,1,1,1,1,0,0,1,1,1],
		[1,1,1,0,0,0,1,1,0,4,0,0,0,0,0,0,1,1,1,1],
		[1,1,1,0,0,0,1,1,0,0,1,1,2,0,1,1,1,0,0,1],
		[1,1,1,1,0,0,1,1,1,0,1,1,0,0,0,0,0,0,5,1],
		[1,0,0,1,1,0,1,1,1,0,1,1,1,1,1,1,0,6,6,1],
		[1,5,4,0,0,0,1,1,0,0,0,0,1,1,1,1,1,0,1,1],
		[1,0,0,0,1,1,1,1,0,4,0,5,1,0,4,0,0,0,1,1],
		[1,1,0,1,1,0,0,0,0,0,0,0,1,0,0,0,1,1,1,1],
		[1,1,0,1,0,6,0,1,1,1,6,1,1,1,0,1,1,1,1,1],
		[1,0,0,0,0,5,0,1,0,0,0,0,1,1,0,0,0,0,1,1],
		[1,0,1,1,1,1,1,1,0,1,1,0,1,1,0,0,4,0,0,1],
		[1,0,1,0,0,0,0,0,0,0,1,0,1,1,1,1,1,1,0,1],
		[1,0,1,0,3,0,1,0,0,0,1,0,1,0,5,0,1,1,0,1],
		[1,0,1,1,1,1,1,0,4,0,1,0,1,0,4,0,0,0,0,1],
		[1,0,0,0,0,0,0,0,1,1,1,0,0,0,0,0,0,1,1,1],
		[1,1,1,1,1,1,1,1,1,1,1,1,1,1,1,1,1,1,1,1],
		[1,1,1,1,1,1,1,1,1,1,1,1,1,1,1,1,1,1,1,1]
	]
}